###############
#      #      #
### ####### # #
# #         # #
# # ##  ### # #
#   #     # # #
# ##### # # # #
#   #   # # # #
#      s#  #f #
###############