###############
#  #  #     # #
#        #  # #
#  ##### #    #
#  #   # #  ###
#    #f# #  #s#
#  ##### #  # #
#  #   # #  # #
#      #      #
###############