###############
#s            #
### #####  #  #
#       #  #  #
# #######  #  #
# #        #  #
# # ### #  #  #
# # #f# #  #  #
#   #   #     #
###############